############
#        O #
#   P   ####
#          #
#######    ########
#  O ##           #
#    ##           #
#          ########
#       XX #
#       #  #
############
