#####
#  P#
# O #
# X #
#   #
##### 